BBBBBBBBBBBBBBBBBBBB
WK...W..C.........PW
W..C.W..C..W..C..C.W
WCW..W.WWW.W....W..W
W.WC.W..C..W..C.WC.W
W.W...CWW..W.WW.WC.W
W..CW...C..W..C.WC.W
WWWWW...WWWW....W..W
WWWCW...C..WW.C..CWW
WWW...C....W....LWWW
WWWWWWWWWWWWWWDWWWWW